######  ##### #########  ########  ####   ##### ###### ## #### #### ###     #########  ########  ####      ##########################
                       @@@@@
    @@@@ 

    @@@@@@@@@@@@@@@@           @@@@@

                                                                               @@@@@

   p                                                                   @@@@
### ### ###       ###### #### ## ###  ###    ###   ######   ###      ######  ###########   #############    ########  #############
